....SSSSS..........
....S...S..........
....SB..S..........
..SSS..BSS.........
..S..B.B.S.........
SSS.S.SS.S...SSSSSS
S...S.SS.SSSSS..TTS
S.B..B..........TTS
SSSSS.SSS.SPSS..TTS
....S.....SSSSSSSSS
....SSSSSSS........
