    #####
    #   #
    #   #
  ###   ##
  #      #
###      ##########
#           $ $ ..#
#     @     $ $ ..#
#####       $ $ ..#
    #         #####
    ###########
