#########
#       #
#   $   #
#       #
#   @   #
#       #
#       #
#      .#
#########
