#########
#       #
#   $  $#
#       #
#   @   #
#       #
#       #
#     ..#
#########
