#########
#       #
#  $  $ #
#       #
#   @   #
#     # #
#    ## #
#     ..#
#########
